111111111111111111111111111111111
1P10C1000C10010C010C100C1C1C0C1E1
1C001C01010C00C1C001C00110C100C01
11C0001C00C1C1C0C100C10C001C001C1
1C0010C1010C00C1C0011C0110C00C1C1
11C0001C00C1C1C0C1000000001C001C1
111111111111111111111111111111111